11111111111111111111111
100000P000C00000E000001
1000000C0000000C0000001
1000000N000C00000000001
11111111111111111111111
