11111111111111111111111
100000P000C000001E10001
1000000C0000000C0C00001
10000000000C00000000001
11111111111111111111111
