11111111111111111111111
100000P000C00000E000001
10000000000000000000001
10000000000000000000001
11111111111111111111111
