11111111111111111
1000000C00P000001
10000000000000001
1000000E000000001
11111111111111111
