1111111111111111111111111111111111
1P00000000000000000000000000000001
10000000000000000000000000E0010101
1000000000000000000000000000000001
100001001000111100C00C0000C0010101
10000100100000110NC00C000000010101
100001111000011000C00C000000010101
10000000100011000NC00C00C000N10101
100000001000111100C00C00N000010101
1111111111111111111111111111111111