11111111111111111111111111111111111111111111111111111111111111111111111111111111111
100000P000C00000E000001000001000001000001000001000001000001000001000001000001000001
1000000C0000000C0000001000001000001000001000000000000000000000000000000000000000001
10000000000C00000000001000001000001000001000001000001000001000001000001000001000001
11111111111111111111111111111111111111111111111111111111111111111111111111111111111