1111111111111111111111111111111111
1P00000000000000000000000000000001
10000000000000000000000000E0010101
100001001000111100C00C0000C0010101
100001001000001100C00C000000010101
100001111000011000C00C000000010101
100000001000110000C00C00C000010101
100000001000111100C00C000000010101
1111111111111111111111111111111111