11111111111111111111111111111111111111111111111111111111111111111
111111111111110PECCCC1C111111111111111111111111111111111111111111
11111111111111111111111111111111111111111111111111111111111111111